5
3 1 2 9 8 5
4 4 5 3 6 5
3 2 7 5 8 5
1 4 7 3 8 5
8 4 6 2 5 5